11111
10E11
100C1
1P001
11111
