1111111111111
101100000C001
1100011111P01
101001CE00001
1111111111111
