1111111111111111111111111
1001000000101000000000001
1000011110011011001010111
11001E0000000000101000001
1P00111000011100011110011
1110100000011100000100011
1010100000111000000010111
100101C010011100000100111
1010110000111000000000111
1001010001011010011000011
1111111111111111111111111
1111111111111101111111111
1111111111111111111111111
1111111111111111111111111
1111111111111111111111111
1111111111111111111111111
1111111111111111111111111
1111111111111111111111111
1111111111111111111111111
1111111111111111111111111
1111111111111111111111111
1111111111111111111111111
1111111111111111111111111
1111111111111111111111111
