1111111111111111111111111
10010000000C1000000000001
10C0010111000011001010111
100000E000001000101000001
1P001100C0011100011110011
1010100000011100000000011
1010100000111000000C00111
1010100000111000C00000111
10101000001110000000C0111
1001010001011010011000011
1111111111111111111111111
