1111111111111
10010000000C1
1000111111001
1PE0110100001
1111111111111
