111111111111111111111
111111111111111111111
110111111111111111111
11P100010C11000111111
110001000111010111111
110111111100010000011
110001000101110111011
111101010101110011C11
111100010001111E11111
111111111111111111111
111111111111111111111